R 800 580
NO ./north.xpm
SO ./south.xpm
WE ./bears.xpm
EA ./east.xpm

S ./sprite.xpm
F 144,238,144
C 176,224,230

111111111111
100000000001
100000000001
100000000111
10N000000001
100000001111
100000000001
100000000001
100000200001
100000000001
111111111111