R   1000 1000
NO  ./ice.xpm
SO ./bears.xpm
WE ./black_bears.xpm
EA ./e_forest.xpm
S ./barrel.xpm
F 176,224,255
C 144,238,144

	111111111111111111111111111111111
	100000000000000020000000000000001
	100000000000000000000000000000001
1111100000000000000S0020000000111111
100000000000000002002000000111111
100000000000000020000000000111111
11111000000000002000000000000001
10000000000000000000000000011111
1000000000000000000000000001

1111111111111111111111111111
1000000000000111110000000001
1000000000000000000000000001
1000000000000000000000000001
10000000000011000000000000011 1111
10000000000011000000000000001 1001
11111111111111111111111111111 1111