R 800 580
NO ./war.xpm
SO ./war.xpm
WE ./war.xpm
EA ./war.xpm

S ./war.xpm
F 144,238,144
C 176,224,230

11111111
10100001
10100001
10000111
10N00001
10001111
11111111
