1111111
1000001
100p001
1000001
1000001
1000001
1111111