11111111
10100001
10100001
10000111
10p00001
10001111
11111111