1111111
1000001
10p0001
1000001
1000001
1000001
1111111