R 800 580
NO ./ice.xpm
SO ./s_bamboo.xpm
WE ./black_bears.xpm
EA ./e_forest.xpm
S ./sprite.xpm
F 144,238,144
C 176,224,230

111111111111
100000000001
110000000011
100002000001
100022200001
100002000111
10N000000001
100000001111
100000000001
100000000001
100000000001
111111111111