R 800 580
NO 0xFFC0CB
SO 0xFF5733
WE 0xFFA07A
EA 0x4B0082

S 0xFF5733
F 0x90EE90
C 0xB0E0E6

11111111
10100001
10100001
10000111
10p00001
10001111
11111111