R   1000 1000
NO ./ice.xpm
SO ./s_bamboo.xpm
WE ./black_bears.xpm
EA ./e_forest.xpm
S ./sprite.xpm
F 144,238,144
C 176,224,230

    111111111111111111111111111111111
    100000000000000000000000000000001
    100000000000000000000000000000001
    100000000000000000000000000111111
    1000000000000000000000000001
    1000000000000000000000000001
11111000000000000111110000000001
10000000000001000100000000011111
10000000N0000000010000000001
1111111111111111111111111111
1000000000000111110000000001
1000000200000000000000000001
1000002220000000000000000001
10000002000011000000000000011 1111
10000000000011000000000000001 1001
11111111111111111111111111111 1111