R 800 580
NO ./1.xpm
SO ./1.xpm
WE ./1.xpm
EA ./1.xpm

S 255,87,51
F 144,238,144
C 176,224,230

11111111
10100001
10100001
10000111
10N00001
10001111
11111111